{
	"numX": 13,
	"numY": 9,
	"size": [64, 64],
	"start": [32, 32],
	"tileNames": ["", "ProtoCoin", "ProtoBox", "Tile01", "Drone", "Eyebot", "Tile02"],
	"tiles": 
	[
		3, 3, 3, 0, 0, 0, 5, 0, 0, 0, 3, 3, 3,
		6, 2, 4, 0, 1, 0, 0, 0, 1, 0, 4, 2, 6,
		6, 0, 0, 1, 3, 1, 0, 1, 3, 1, 2, 2, 6,
		6, 2, 3, 0, 1, 0, 3, 0, 1, 0, 0, 2, 6,
		6, 0, 0, 0, 3, 0, 0, 3, 0, 0, 0, 0, 6,
		6, 0, 2, 1, 0, 0, 0, 0, 3, 1, 2, 0, 6,
		6, 0, 0, 0, 1, 1, 1, 1, 1, 0, 2, 0, 6,
		6, 2, 3, 0, 0, 2, 0, 0, 0, 2, 0, 2, 6,
		3, 3, 3, 3, 3, 3, 3, 3, 3, 3, 3, 3, 3
	]
}
